0000000000000m0m00000000000000
mmm0mmmmmmmm0m0m0mmmmm0mmmmmmm
m0000000m0000m0m0m00000000000m
m0m0m0m0m0m00m0m0m0mmmmm00m00m
m0m0m0m0m00mmm0mmm00000m0mmm0m
m00000m000000000000m0m0000000m
m0mmmmmm0mmmm0m0mm0m0mmmmm000m
m0000m00000000m000000m0000000m
m0mm0m0m0m0000m00m0m000m0mm00m
m0m0000m0m0mmm0mmm0mmm0m0m000m
m0m0mm00000000000000000m0mmm0m
m0m00m0m0mmmmm0mmm0m0mmm0m000m
m0mm0m0m000m0000000m000m000m0m
m0m00m0m0m0m0mmm0m0m0m0m0mmm0m
m00000000m000m0m0m000m0000m00m
mmmmmmmm0mmm0f0m0mmm0mmm00m00m
m00000000m000m0m0m000m0000m00m
m0m00m0m0m0m00mm0m0m0m0m0mmm0m
m0mm0m0m000m0000000m000m000m0m
m0m00m0m0mmmmm0m0m0m0mmm0m000m
m000mm00000000000000000m0mmm0m
m0m0000m0m0mmmmmmm0mmm0m0m000m
m0mm0m0m0m0m00m00m0m000m0mm00m
m0000m00000000m000000m00000000
m0mmmmmm0mmmm0m0mm0m0mmmmm000m
m00000m000000000000m0m0000000m
m0m0m0m0m00mmm0mmm00000m0mmm0m
m0m0m0m0m0mm0m0m0m0mmmmm00m00m
m0000000m00m0m0m0m00000000000m
mmmmmmmmmmmm0m0m0mmmmmmm0mm0mm
0000000000000m0m00000000000000
